0,0,0,0,0,0,0,0,0,0,0,0,0,0,0,0,0,0,0,0
0,0,0,0,0,0,0,0,0,0,0,0,0,0,0,0,0,0,0,0
0,0,0,0,0,0,0,0,0,0,0,0,0,0,0,0,0,0,0,0
0,0,0,0,0,0,0,0,0,0,0,0,0,0,0,0,0,0,0,0
0,0,0,0,0,0,0,0,0,0,0,0,0,0,0,0,0,0,0,0
0,726,727,728,729,730,731,732,733,734,735,0,0,0,0,0,0,0,0,0
0,784,785,786,787,788,789,790,791,792,793,0,0,0,0,0,0,0,0,0
0,0,0,0,0,0,0,0,0,1047,1048,0,0,0,0,0,557,0,0,0
0,0,0,0,0,0,0,0,0,0,609,610,611,612,613,614,615,616,617,618
0,0,0,0,0,0,0,0,0,0,667,668,669,670,671,672,673,674,675,676
