0,0,0,0,0,0,0,0,0,0,0,0,0,0,0,0,0,0,0,0
0,0,0,0,0,0,0,0,0,0,0,0,0,0,0,0,0,0,0,0
0,0,0,0,0,0,0,0,0,0,0,0,0,0,0,0,0,0,0,0
0,0,0,0,0,0,0,0,0,0,0,0,0,0,0,0,0,0,0,0
0,0,0,0,0,0,0,0,0,0,0,0,0,0,0,0,0,0,0,0
0,726,0,0,0,0,0,0,0,0,0,0,0,0,0,0,0,0,0,0
0,0,0,0,0,0,0,0,0,0,0,803,804,805,806,0,0,0,0,0
0,0,0,0,0,0,0,0,0,0,0,861,862,863,864,0,0,0,0,0
0,0,0,0,0,0,0,1103,1104,1105,0,919,920,921,922,923,0,0,0,0
0,0,0,0,0,0,0,0,0,0,0,977,978,979,980,981,0,0,0,0
