0,165,166,167,168,0,0,0,0,0,0,0,0,0,0,0,0,0,0,0
222,223,224,225,226,227,0,0,0,0,0,0,0,0,0,0,0,0,0,0
280,281,282,283,284,285,0,0,0,0,0,0,0,0,0,0,0,0,0,0
338,339,340,341,342,343,0,0,0,0,0,0,0,0,0,0,0,0,0,0
0,0,0,0,0,0,0,0,0,0,0,0,0,0,0,0,0,0,0,0
0,0,0,0,0,0,0,0,0,0,0,0,0,0,0,0,0,0,0,0
0,0,0,0,0,0,0,0,0,0,0,0,0,0,0,0,0,0,0,0
0,0,0,0,0,0,0,0,0,0,0,0,0,0,0,0,0,0,0,0
0,0,0,0,0,0,0,0,0,0,0,0,0,0,0,0,0,0,0,0
0,0,0,0,0,0,0,0,0,0,0,0,0,0,0,0,0,0,0,0
